1111 111111111 1111
1        1        1
1 11 111 1 111 11 1
1 11 111 1 111 11 1
1                 1
1 11 1 11111 1 11 1
1    1   1   1    1
1111 111 1 111 1111
1111 1       1 1111
1111 1 11211 1 1111
11     12221     11
   1 1 12221 1 1   
1111 1 11111 1 1111
1111 1   0   1 1111
1111 1 11111 1 1111
1        1        1
1 11 111 1 111 11 1
1  1           1  1
11 1 1 11111 1 1 11
1    1   1   1    1
1 111111 1 111111 1
1                 1
1111 111111111 1111